8  16
0 0 2 0 0 0 0 0 0 0 0 0 2 0 0 0
1 2 2 2 1 0 1 3 1 1 0 3 2 0 0 0
0 0 2 2 2 1 1 0 0 1 3 0 2 0 0 0
1 2 1 2 2 2 1 0 0 3 2 2 0 3 0 1
0 3 0 1 0 2 0 0 0 2 0 0 1 2 1 0
1 2 0 3 3 0 1 3 1 1 2 2 1 2 0 1
0 0 1 2 0 1 1 2 0 1 1 2 0 1 2 0
0 0 2 0 1 0 1 1 1 1 0 1 2 0 1 0
 
15
2 9
3 1
3 6
3 15
5 7
0 6
1 12
5 3
7 3
0 5
2 12
4 2
0 4
7 13
5 13