5  6
1  1  1  1  1  3
0  1  3  0  3  2
1  1  2  2  2  2
2  3  2  0  2  2
0  0  1  2  0  2
 
2
0 2
3 2


